{
"size":[5,5,1],
"data":[
"#####",
"#...#",
"#...#",
"#...#",
"#.###"]
]