{
"size":[25,11,1],
"data":[["#########################",
		"#...#...#...#...#....#..#",
		"#...#...#...#...#.####..#",
		"#...#...#...#...#....#..#",
		"#.#####.#.#####.#.#####.#",
		".........................",
		"#.#####.#.#####.#.#####.#",
		"#...#...#...#...#.......#",
		"#...#...#...#...#.......#",
		"#...#...#...#...#.......#",
		"#########################"]]
}